000000000000000000000000000000000000000
051121121120000000021121121120000000000
000000000010000000010000000010000000000
000000000010000000010000000010000000000
000000000020000000020000000020000000000
000000000010000000010000000010000000000
000000000010000000010000000010000000000
000000000020000000020000000020000000000
000000000010000000010000000010000000000
000000000010000000010000000010000000000
021121121120000000021121121120000000000
010000000000000000010000000000000000000
010000000000000000010000000000000000000
020000000000000000020000000000000000000
010000000000000000010000000000000000000
010000000000000000010000000000000000000
020000000000000000020000000000000000000
010000000000000000010000000000000000000
010000000000000000010000000000000000000
021121121121121121121121121120000000000
000000000000000000010000000010000000000
000000000000000000010000000010000000000
000000000000000000020000000010000000000
000000000000000000010000000010000000000
000000000000000000010000000030000000000
000000000000000000020000000000000000000
000000000000000000010000000000000000000
000000000000000000010000000000000000000
000000000021121121120000000000000000000
000000000010000000010000000000000000000
000000000010000000010000000000000000000
000000000020000000020000000000000000000
000000000010000000010000000000000000000
000000000010000000010000000000000000000
000000000020000000020000000000000000000
000000000010000000010000000000000000000
000000000010000000010000000000000000000
000000000021121121120000000000000000000
000000000000000000000000000000000000000
000000000000000000000000000000000000000