000000000000000000000000000000000000000
000000000000000000000000000000000000000
000115112111211120000000000000000000000
000000000000000010000000000000000000000
000000000000000010000000000000000000000
000000000000000010000000000000000000000
000000000000000020000000000000000000000
000000000000000010000000000000000000000
000000000000000010000000000000000000000
000000000000000010000000000000000000000
000000000000000020000000000000000000000
000000000000000010000000000000000000000
000000000000000010000000000000000000000
000000000000000010000000000000000000000
000021112111211120000000000000000000000
000010000000000000000000000000000000000
000010000000000000000000000000000000000
000010000000000000000000000000000000000
000020000000000000000000003000000000000
000010000000000000000000001000000000000
000010000000000000000000001000000000000
000010000000000000000000001000000000000
000020000000000021112111211121112111200
000010000000000010000000001000000000100
000010000000000010000000002000000000100
000010000000000010000000001000000000100
000020000000000020000000001000000000200
000010000000000010000000001000000000100
000010000000000010000000002000000000100
000010000000000010000000001000000000100
000021112111211120000000001121112111200
000000000000000000000000000000000000000
000000000000000000000000000000000000000
000000000000000000000000000000000000000
000000000000000000000000000000000000000
