0000000000000000000000000000000000000000000000000
0000000000000000000000000000000000000000000000000
0000000000000000000000000000000000000000000000000
0000000000000000000000000000000000000000000000000
0000000010000000000000000000000000000000111110000
0000000010000000000000000000000000000000100010000
0000000010000000000000000000000000000000100010000
0000000010000000000000000000000000000000100010000
0000111121112111211121111111211121112111211110000
0000000010000000000010000000100000000000100000000
0000000010000000000010000000100000000000100000000
0000000010000000000010000000100000000000100000000
0000000020000000000020000000200000000000200000000
0000000010000000000010000000100000000000100000000
0000000010000000000010000000100000000000100000000
0000000010000000000010000000100000000000100000000
0000000020000000000021112111200021112111200000000
0000000010000000000000000000000010000000100000000
0000000010000000000000000000000010000000100000000
0000000010000000000000000000000010000000100000000
0000000020000000000000000000000020000000100000000
0000000010000000000000000000000010000000100000000
0000000010000000000000000000000010000000100000000
0000000010000000000000000000000010000000100000000
0000111121112111211111113000000021112111200000000
0000100010000000000000000000000000000000100000000
0000100010000000000000000000000000000000100000000
0000100010000000000000000000000000000000100000000
0000111110000000000000000000000000000000200000000
0000000000000000000000000000000000000000100000000
0000000000000000000000000000000000000000100000000
0000000000000000000000000000000000000000100000000
0000000000000000000000000000000000000000200000000
0000000000000000000000000000000000000000100000000
0000000000000000000000000000000000000000100000000
0000000000000000000000000000000000000000100000000
0000000000000000000000000000000021112111211120000
0000000000000000000000000000000010000000100010000
0000000000000000000000000000000010000000100010000
0000000000000000000000000000000010000000100010000
0000000000000000000000000000000020000000200020000
0000000000000000000000000000000010000000100010000
0000000000000000000000000000000010000000100010000
0000000000000000000000000000000010000000100010000
0000000000000000000000000000000021112111200040000
0000000000000000000000000000000000000000000010000
0000000000000000000000000000000000000000000010000
0000000000000000000000000000000000000000000000000
0000000000000000000000000000000000000000000000000
