00000000000000000000000000000000000000000000000000000000000
00000000000000000000000000000000000000000000000000000000000
00000030000000000000000000000000000000000000000000000000000
00000010000000000000000000000000000111110111110111010001000
00000010111211211211211121112000000001000100000010010010000
00000010000000000000000000001000000001000100000010010100000
00000010000000000000000000001000000001000111110010011000000
00000010000000000000000000001000000001000100000010010100000
00000010000000002111211121112000000001000100000010010010000
00000010000000001000000010000000000001000111110111010001000
00000010000000001000000020000000000000000000000000000000000
00000010121121112000100010000000000000000000000000000000000
00000010000000001000100010000100000000000000000000001000000
00000010000000001000100020000100000000000000000000001000000
00000010000000002000100010000100000000000000000000001000000
00000010000000001000100010000100000000000000000000001000000
00000010000000001000100020000111111111111111100000001000000
00000021112112112000100010000100010000000100000000001000000
00000010000000000000100000000100010000000100000000001000000
00000010000000000000100000000100010000000100000000001000000
00000020000000000000100000000100010000000100000000001000000
00000010000000000000100000000100010000000111111111111000000
00000010000000001111111111111100010000000000000000000000000
00000020000010000000000000000000010000000000000000000000000
00000010000020000000000000000000010000000000000000000000000
00000010000010000000000000000000010010000000000000000000000
00000020000010000000000000000000010010000000000000000000000
00000010000010000000000000000000010021121121121121121120000
00000011211120001121112111212100010010000000000000000010000
00000000000010001000000000000000010010000000000000000010000
00000000000010002000000000000000010010000000000000000010000
00000000000020001000000000000000010020000000000000000020000
00000000000010001000011111111111110010000000000000000010000
00000000000010002000000000000000000010000000000000000010000
00000000000020001000000000000000000010000000000000000010000
00000000000010001000000000000211211121121120000021121120000
00000010000010001000000000000100000000000010000010000000000
00000020000020002000000000000100000000000010000010000000000
00000010000010001000000112111200000000000010000020000000000
00000010000010001000000000000100000000000010000010000000000
00000020000020001000000000000100001002111120000010000000000
00000010000010002111120000000200002001000000000020000000000
00000012112110001000010000000100001001000000000010000000000
00000020000000001000010000000100001001000000000010000000000
00000010000000001000020000000200002002000000000010000000000
00000010000000002000010000000100001001012111211120000000000
00000020000000001000011211210100001001000001000010000000000
00000010000000001000010000000100002001000002000010000000000
00000010000000002000020000000200001002000001000010000000000
00000020000000001000010000000100001001000001000010000000000
00000010001211211000010000000000002001000001000021111200000
00000010000000000000010000000000001001000002000000000100000
00000020000000000000021112111211211002000001000000000100000
00000010000000000000000000010000000001000001000000000100000
00000010000000000000000000020000000001121112000012111200000
00000020000000000000000000010000000000000000000000000100000
00000010000000000000000000010000000000000000000000000100000
00000010000000000000000000020000000000000000000000000100000
01221121121121121211211211211211211211211211211211211211170
00000000000000000000000000000000000000000000000000000000000