00000000000000000000000000000000000000000000000000
00000000000000000000000000000000000000000000000000
00000000000000000000000000000000000000000000000000
00000000000000000000000000000000000000000000000000
00000000000000021121121121121121120000000000000000
00000000000000010000000010000000010000000000000000
00000000000000010000000010000000010000000000000000
00000000000000020000000020000000020000000000000000
00000000000000010000000010000000010000000000000000
00000000000000010000000010000000010000000000000000
00000000000000021121121121121121120000000000000000
00000000000000000000000010000000000000000000000000
00000000000000000000000010000000000000000000000000
00000000000000000000000020000000000000000000000000
00000000000000000000000010000000000000000000000000
00011111111110000000000010000000000000000000000000
00010010010010000000000010000000000000000000000000
00010010010010000000000020000000000000000000000000
00011121121110000000000010000000000021112111200000
00010010010010000000000010000000000010000000100000
00010010010010000000000010000000000010000000100000
00011121121110000000000020000000000010000000100000
00010010010010000000000010000000000020000000200000
00010010010010000000000010000000000010000000100000
00011111111110000000000010000000000010000000100000
00010010010021112111211151112111211120000000100000
00011111111110000000000010000000000010000000100000
00010010010010000000000010000000000010000000100000
00010010010010000000000010000000000020000000200000
00011121121110000000000010000000000010000000100000
00010010010010000000000030000000000010000000100000
00010010010010000000000000000000000010000000100000
00011121121110000000000000000000000021112111200000
00010010010010000000000000000000000000000000000000
00010010010010000000000000000000000000000000000000
00011111111110000000000000000000000000000000000000
00000000000000000000000000000000000000000000000000
00000000000000000000000000000000000000000000000000
00000000000000000000000000000000000000000000000000
00000000000000000000000000000000000000000000000000
00000000000000000000000000000000000000000000000000
00000000000000000000000000000000000000000000000000
00000000000000000000000000000000000000000000000000
00000000000000000000000000000000000000000000000000
00000000000000000000000000000000000000000000000000
00000000000000000000000000000000000000000000000000
00000000000000000000000000000000000000000000000000
00000000000000000000000000000000000000000000000000
00000000000000000000000000000000000000000000000000
00000000000000000000000000000000000000000000000000
00000000000000000000000000000000000000000000000000