0000000000000000000000000000000000000000000000000
0000000000000000000000000000000000000000000000000
0000000000000000000000000000000000000000000000000
0000000000000000000000000000000000000000000000000
0000000000000000000000000000000000000000000000000
0000000000000000000000000000000000000000000000000
0000000000000000000000000000000000000000000000000
0011511121112111211121122211000000000000000000000
0000000000000000000010000000000000000000000000000
0000000000000000000010000000000000000000000000000
0000000000000000000010000000000000000000000000000
0000000000000000000020000000000000000000000000000
0000000000000000000010000000000000000000000000000
0000000000000000000010000000000000000000000000000
0000000000000000000010000000000000000000000000000
0000000011222111211120000000000000000000000000000
0000000000000000000010000000000000000000000000000
0000000000000000000010000000000000000000000000000
0000000000000000000010000000000000000000000000000
0000000000000000000020000000000000000000000000000
0000000000000000000010000000000000000000000000000
0000000000000000000010000000000000000000000000000
0000000000000000000010000000000000000000000000000
0000000000000000000021112111222110000000000000000
0000000000000000000010000000000000000000000000000
0000000000000000000010000000000000000000000000000
0000000000000000000010000000000000000000000000000
0000000000000000000020000000000000000000000000000
0000000000000000000010000000000000000000000000000
0000000000000000000010000000000000000000000000000
0000000000000000000010000000000000000000000000000
0000000011222111211120000000000000000000000000000
0000000000000000000010000000000000000000000000000
0000000000000000000010000000000000000000000000000
0000000000000000000010000000000000000000000000000
0000000000000000000020000000000000000000000000000
0000000000000000000010000000000000000000000000000
0000000000000000000010000000000000000000000000000
0000000000000000000010000000000000000000000000000
0000000000000000000021112111211121312121210000000
0000000000000000000010000000000000000000000000000
0000000000000000000010000000000000000000000000000
0000000000000000000010000000000000000000000000000
0000000000000000000020000000000000000000000000000
0000000000000000000020000000000000000000000000000
0000000000000000000020000000000000000000000000000
0000000000000000000010000000000000000000000000000
0000000000000000000010000000000000000000000000000
0000000000000000000000000000000000000000000000000
0000000000000000000000000000000000000000000000000